WWWWWWWWWW
W  B     W
W  HHHH  W
W        W
W    WWXXW
W    W
W  S W   W
W    W   W
W        W
WWWWWWWWWW