WWWWWWWWWW
W     b  W
W bC  WW W
WWW    C W
W   RB X W
W   HHHH W
W  Q     W
W  S     W
W  RTTTR W
WWWWWWWWWW