WWWWWWWWWW
WS       W
W R R C  W
W H HHH  W
W VC bXR W
W V WWW  W
W V     HW
W X     CW
WB YRA   W
WWWWWWWWWW