WWWWWWWWWW
W     b  W
W b   WW W
WWW    C W
W   AB X W
W  AHHHH W
W        W
W  S     W
W  RTTTR W
WWWWWWWWWW