WWWWWWWWWW
W   V b WW
W     WXWW
WWWP  C WW
W   ABX WW
W   HHHH W
W        W
W  S     W
W RTTTR  W
WWWWWWWWWW