WWWWWWWWWW
W V  S   W
W V  H H W
W V  X   W
W V  H H W
W V      W
W VWW  B W
W    W   W
W        W
WW WWWWWWW