WWWWWWWWWW
W SR  b  W
W  R WWW W
W  B     W
W        W
W   HHHH W
W        W
W        W
W        W
WWWWWWWWWW