WWWWWWWWWW
W     b  W
W b   WW W
WWWT   C W
W   AB X W
W   HHHH W
W        W
W  S     W
W  RTTTR W
WWWWWWWWWW