WWWWWWWWWW
W       BW
WS b V   W
W  HHH   W
W    WWXXW
W    W
W TRWW   W
W    W   W
W    C T W
WWWWWWWWWW