WWWWWWWWWW
W     b  W
W b   WW W
WWW      W
W   AB   W
W   HHHH W
W  C     W
W  S     W
W   TTTR W
WWWWWWWWWW