WWWWWWWWWW
W  V S V W
W  V b V W
W  V W V W
W  V b V W
W  V W V W
W  V   VBW
W   HHH  W
W   R R TW
WWWWWWWWWW