WWWWWWWWWW
WRRb    BW
W  HHHH  W
W  R     W
W    WWXXW
W    W
W  SWW   W
W    W   W
W    C T W
WWWWWWWWWW