WWWWWWWWWW
W     b  W
W b   WW W
WWW      W
W   AB   W
W   HHHH W
W BC   A W
W  S     W
W      L W
WWWWWWWWWW