WWWWWWWWWW
W     b  W
W b   WW W
WWW    C W
W   TB X W
W   HHHH W
W        W
W  S     W
W  RTTTR W
WWWWWWWWWW