WHHHHHHHHW
V X  b bXV
VTBT WXWXV
VWTWWWXXXV
V WWWWWXWV
V     WX V
V R bA W V
VWWWW    V
V       SV
WHHHHHHHHW