WWWWWWWWWW
WS      BW
W   R C  W
W HHHHH  W
W C  b C W
W   WW   W
WH      HW
WC  XX  CW
W   WW   W
WWWWWWWWWW